{
  "level_name": "Courtyard Apartments",
  "initial_fuel": 55,
  "hint_battery": 3,
  "map_grid": [
    "WWWWWWWWWWWWWWWWWWWWWWWW",
    "WWWWWWWWWWW11WWWWWWWWWWW",
    "WWWWWWWWWWWS1WWWWWWWWWWW",
    "WWWWWWWWWWW11WWWWWWWWWWW",
    "WWWWWWWWWWW11WWWWWWWWWWW",
    "WWWWWWW1221221221WWWWWWW",
    "WWWDWWW2212212212WWWWWWW",
    "W1111112122122122111111W",
    "W1111111221221221111111W",
    "WWWWWWW2212212212WWWDWWW",
    "WWWWWWW21221222D2WWWWWWW",
    "WWWWWWWWWWW11WWWWWWWWWWW",
    "WWWWWWWWWWW11WWWWWWWWWWW",
    "WWWWWWWWWWW11WWWWWWWWWWW",
    "WWWWWWWWWWW11WWWWWWWWWWW",
    "WWWWWWWWWWWWWWWWWWWWWWWW"
  ]
}