{
  "level_name": "Grid Village",
  "initial_fuel": 50,
  "hint_battery": 3,
  "map_grid": [
    "WWWWWWWWWWWWWWWWWWWWWWWW",
    "WWWWW121WWWWWWWW121WWWWW",
    "WWWWD121WWWWWWWW121DWWWW",
    "W1111111111111111111111W",
    "W2222111222222221112222W",
    "W1111111111111111111111W",
    "WWWWW121WWWWWWWW121WWWWW",
    "WWWWW121WWWWWWWW121WWWWW",
    "WWWWW121WWWWWWWW121WWWWW",
    "W1111111111111111111111W",
    "W2222111222222221112222W",
    "W111S111111111111111111W",
    "WWWWW121WWWWWWWW121DWWWW",
    "WWWWW121WWWWWWWW121WWWWW",
    "WWWWW121WWWWWWWW121WWWWW",
    "WWWWWWWWWWWWWWWWWWWWWWWW"
  ]
}