{
  "level_name": "City Core Bypass",
  "initial_fuel": 60,
  "hint_battery": 2,
  "map_grid": [
    "WWWWWWWWWWWWWWWWWWWWWWWW",
    "WWWWWWWWWWWWWWWWWWWWWWWW",
    "WW111S1211321111112211WW",
    "WW11121121321111213112WW",
    "WW13WWW1WWWWWWW1WWWW11WW",
    "WW11W11112122111111W11WW",
    "WW12WW1WW2WW1WW1WW1W31WW",
    "WW23W1311D121313111W12WW",
    "WW11121WW1WW1WW1WW1W11WW",
    "WW21W12111112111213W13WW",
    "WW12WW1WW1WW1WW11D3W11WW",
    "WW31W11121211111121W13WW",
    "WW11WWW1WWWWWWWWWWWW22WW",
    "WW12112132DWWWWWWWWW32WW",
    "WWWWWWWWWWWWWWWWWWWWWWWW",
    "WWWWWWWWWWWWWWWWWWWWWWWW"
  ]
}