{
  "level_name": "Twin Blocks with Park",
  "initial_fuel": 50,
  "hint_battery": 3,
  "map_grid": [
    "WWWWWWWWWWWWWWWWWWWWWWWW",
    "WWWWWWWWW212121WWWWWWWWW",
    "WWWWWWWWW111111WWWWWWWWW",
    "WWWWWWWWW21D121WWWWWWWWW",
    "WWWWWWWWW111111WWWWWWWWW",
    "WWWWWWWWW212121WWWWWWWWW",
    "WWWWWWWWW111111WWWWWWWWW",
    "W11D1111121S12111111D11W",
    "WWWWWWWWW111111WWWWWWWWW",
    "WWWWWWWWW212121WWWWWWWWW",
    "WWWWWWWWW111111WWWWWWWWW",
    "WWWWWWWWW212121WWWWWWWWW",
    "WWWWWWWWW111111WWWWWWWWW",
    "WWWWWWWWW212121WWWWWWWWW",
    "WWWWWWWWW111111WWWWWWWWW",
    "WWWWWWWWWWWWWWWWWWWWWWWW"
  ]
}