{
  "level_name": "Suburban Street",
  "initial_fuel": 50,
  "hint_battery": 3,
  "map_grid": [
    "WWWWWWWWWWWWWWWWWWWWWWWW",
    "WWWWWWWWWWWWWWWWWWWWWWWW",
    "WWWWWWDWWWWWWWWWWWDWWWWW",
    "W1111111111111111111111W",
    "W1111111111111111111111W",
    "WWWW1WWWWWW1WWWWWW1WWWWW",
    "WWWW1WWWWWW1WWWWWW1WWWWW",
    "WWWW1WWWWWW1WWWWWW1WWWWW",
    "WWWW1WWWWWW1WWWWWW1WWWWW",
    "WWWW1WWWWWW1WWWWWW1WWWWW",
    "W1111111111122222222222W",
    "W1111111111122222222222W",
    "WWWWSWWWWWWWWWWWDWWWWWWW",
    "WWWWWWWWWWWWWWWWWWWWWWWW",
    "WWWWWWWWWWWWWWWWWWWWWWWW",
    "WWWWWWWWWWWWWWWWWWWWWWWW"
  ]
}